111111111111111111111
100P00000000X00C00000000000X00001
10000X000C0000000C0000C01
1000000C000000000X000000E01
1111111111111111111111111111111
