111111111111111111111111111111
100P00000000X01C10000000X00XC1
11000X000C000000000000C00000X1
1C00000C000000000X000000000E01
111111111111111111111111111111
