111111111111111111111111111111
100P00000000X00C00000000X00001
10000X000C000000000000C0000111
1000000C000000000X0000000001E1
111111111111111111111111111111
