111111111111111111111111111111
1P1000000000X00C00000000X00001
11000X000C000000000000C0000C01
1000000C000000000X000000000E01
111111111111111111111111111111
