1111
1P01
1C01
10C1
1X01
1E01
1111
