1111111111111111111111111111111111
1E00000000X0000C00000C0000000X00X1
10000101001000001010010000X0010101
1010010010101010001001000000010101
1P00X0000C00C000000000X000000000C1
1111111111111111111111111111111111
