11111111111111111111111111111111111111111111
1000000000100000000C00000000000000000000C001
10P0000000100000000000000000C000000000000001
100000000010000X0000000XC00000000000X0000001
1000000000100000000000000000C00000000C000001
1000000000000000C00000000000000000000000C001
100C0000010000000000000000000000000000000001
1000000001000000000000000X000000000000000001
10000000010000000000000000000000000001111111
1000000000000000C000000000000000000000000001
100C00000000X0000000000000000010100000X00001
1000000000000000000000000000001E1000000010C1
11111111111111111111111111111111111111111111
