111111111111111111111111111111
100P00000000X00000000000X00001
10000X000000000000000000000001
10000000000000000X000000000E01
111111111111111111111111111111
