111111111111111111111111111111
100P00000000000C00000000000001
100000000C000000000000C0000C01
1000000C0000000000000000000E01
111111111111111111111111111111
