1111111111111111
1P0000000C0000E1
1100C00000000001
1C000000000001E1
1111111111111111
