1111111111111111
1P0000000C000001
1100C000I0000001
1C000000000001E1
1111111111111111
