1111111111111111
1P00000C000001
1100C0000000C00001
1C0000000001E1
11111111111111111111
