1111111101111111
1P0000000C000001
1100C00000000001
1C000000000001E0
1111011111111111
