1111111111111111
1P0000000C000001
1100C00000000001
1C100000000001E1
1111111111111111
