1111111111111111
1P1000000C000001
1100C00000000001
1C000000000001E1
1111111111111111
