11111
1P0C1
10001
1E001
10001
11111
