11111
1P0C1
10001
1E001
100X1
11111
