111111111111111111111111111111
10P000000000X00C00000000X00001
10000X000C000000000000C0000C01
1000000C000000000X000000000E01
111111111111111111111111111111
