111111111111111111111111111
10P000000000000C00000000X01
10000X000C000000000000C0001
10000000000000000X0000000E1
111111111111111111111111111
