1111111111111111
1P00000000000001
1100000000000001
10000000000001E1
1111111111111111
