111111111111111111111111111111111
1P0000000000000000000000000001001
100000000000000000000000000001001
100000000000000000000000000001001
100000000000000000000000000001001
1000000000000000C0000000000001001
100000000000000000000000000001001
100000000000000000000000000001001
100000000000000000000000000001001
100000000000000000000000000001001
100000000000000000000000000001001
100000000000000000000000000001001
100000000000000000000000000001001
100000000000000000000000000001001
100000000000000000000000000000001
111111111111111111111111111111001
1000000000000000000000000000000E1
111111111111111111111111111111111
